CWWWWWWWWWWWWWWWWWWWWWC
WKEEEEEEEEEEEEEEEEEEEKW
WEWGWEWWWWWGWWWWWEWGWEW
WEWPWEGFEFEFEFEFGEWPWEW
WEWGWEWWWWWWWWWWWEWGWEW
WEEEEKEEEEEEEEEEEKEEEEW
WEWGWWCECWWEWWCECWWGWEW
WEWFEFWEWEEEEEWEWFEFWEW
WEWGWEWEWEEEEEWEWEWGWEW
WKEEWFWEWEEEEEWEWFWEEKW
CWWEWEWECWWWWWCEWEWEWWC
GFGEGFGEEEEEEEEEGFGEGFG
CWWEWWWECWEEEWCEWWWEWWC
WKEEEEEKWEWEWEWKEEEEEKW
WEWGWEWGCWCECWCGWEWGWEW
WEWFWEWSEFGEGFESWEWFWEW
WEWEWEWECWWEWWCEWEWEWEW
WEWFWEWFWEEKEEWFWEWFWEW
WEWGWEWEWECWCEWEWEWGWEW
WEEEEEWFWEWFWEWFWEEEEEW
WEWGWEWGWEWGWEWGWEWGWEW
WEWPWKEEEEEEEEEEEKWPWEW
WEWGWEWWWWWGWWWWWEWGWEW
WKEEEEGFEFEFEFEFGEEEEKW
CWWWWWWWWWWWWWWWWWWWWWC