01111111111111111111111
00000000000000000000000
00000011111011111000000
00000030000000001000000
00020011111111111002000
00000000000000000000000
00001110011011100110000
00000000000000000000000
00020000000000000002000
00000000000000000000000
31100000311111200000112
30103010000000003010301
01101110011001101110111
00000000000000000000000
00000000312031200000000
00000000001030000000000
00000000011011100000000
00000000000000000000000
00020000000110000002000
00000000000000000000000
00000002000200020000000
00000000000000000000000
00020011111011111002000
00000030000000001000000
31111111111111111111112